##########
#@.......#
########.#
#........#
#.########
#........#
#####.####
#........#
#......#..
##########